#############################
        #    #####    #### ##
####### #### ##    ## ##   ##
##           ## ##       ####
####### ####### ##### #######
##      ####### #      ######
#######           ####       
#############################