# ###########################
#       #    #####    #### ##
####### #### ##    ## ##   ##
#            ## ##       ####
####### ####### ##### #######
##      ####### #      ######
#######           ####       
#############################
