# #######
#   ## ##
# #### ##
#       #
####### #